company_name|website
10 Gage Ridge Roofing|10gageridgeroofing.com
101 Industries|www.101industries.com
180 Contractors|www.180contractors.com
1st 4 Roofing Services|1st4roofing.co.uk
1st Choice Roofing Contractors|1stchoiceroofingvt.com
1st Roofing Maple Grove|www.1stroofingmaplegrovemn.com
1st Roofing Services|1st4roofingservicesltd.co.uk
3 Clovers Roofing & Construction|3cloversconstruction.com
360 Roofing Services|360roofingservices.com
3MG Roofing & Solar|www.3mg.com
3MG Roofing and Solar|3mgroofing.com
4th Generation - Flat Roofing Services|unknown
A & L Roofing Services|alroofingleeds.com
A A Abbey Roofing & Building Contractors|aaabbeyroofing.co.uk
A Affordable Roofing & Services|aaffordableroofing.com
A Call Away Roofing|www.acallawayroofing.com
A J H Metal Roofing And Cladding|ajhroofingltd.co.uk
A P Benson Roofing & Building|ap-benson.co.uk
A-1 All American Roofing San Diego|www.americanroofco.com
A-best Roofing|abestroofing.com
A-J Roofing|www.a-jroofing.com
A-L-S Roofing|alsroofing.com
A. 1. Alston Roofing Services|a-1-roofing.com
A.Baul Roofing Contractors|unknown
A.J. Donald Roofing Services|donaldroofing.co.uk
A.J.L. Roofing Contractors|ajlroofing.co.uk
A&A Roofing Services|aandaroof.com
A&D Roofing And Building Services|aanddroofingservices.co.uk
A&E Brothers Roofing|www.aebrothersroofing.com
A1 Pro Services Roofing|www.a1proservicesroofing.com
A1 Roofing|a1-roofing.net
A1 Roofing System|a1roofingsystem.com
Aa Roofing Services|aaabbeyroofing.com
AAA Roofing|www.aaarfg.com
AAA ROOFING SERVICES|aaaroofingsvc.com
AAAA Contractors and Roofing|aaaacontractors.com
Abbey Roofing Contractors|abbey-roofing.co.uk
ABC Roofing Co.|www.abcroofingco.com
Able Roofing|www.ableroof.com
Able Roofing Services|able-roofing.net
Able Roofing Services Nottingham|roofersnottingham.com
Absolute Construction|www.absoluteroofingcompany.net
Absolute Construction & Roofing|absoluteconstructionandroofing.com
ABSOLUTE PROFESSIONAL ROOFING CONTRACTORS|absoluteprc.com
Absolute Roofing (Other Commercial Services)|www.absoluteroofingfla.com
Absolute Roofing Contractors|absolute-roofing.co.uk
Ac Roofing Services|unknown
Academe Roofing Services|academeroofing.co.uk
Academy Roofing & Sheet Metal Co.|academyroofing.com
ACB Group|www.acbgroup.ie
ACE Roofing Services|ace-roofs.com
Acko Beach Property Services|ldroofingservices.co.uk
ACME Roofing Services|acmeroofingservices.com
Acorn Roofing Supply|55buildingsupply.com
Acs Roofing Services|unknown
Action Roofing|actionroofing.com
Action Roofing (Commercial Services)|www.action-roofing.com
Active Roofing|www.activeroofing.com
Adam Vaillancourt Roofing|www.adamvroofing.com
Adams Roofing Services|adamsroofing.co.uk
Admiral Roofing Ltd.|admiralroofing.ca
Advanced Roofing|www.advancedroofing.com
Advanced Roofing Services|advancedroofingsvcs.com
Advanced Roofing Services (Northampton)|advancedroofing-northampton.co.uk
Advanced Specialist Roofing Services|unknown
Advocate Construction|www.advocateconstruction.com
Advosy Roofing|www.advosy.com
Aegis Roofing Contractors|aegisroofingcontractors.co.uk
Affordable Roofing Contractors|affordableroofing.biz
Agape Roofing|www.agaperoof.com
AGU Roofing & Solar|www.agu-roofing.com
Aintree Roofing Services|aintreeroofingservices.co.uk
Alabama Discount Roofing|alabamadiscountroofing.com
Alamo Roofing Contractors|alamoroofingcontractors.com
Alan Brown Roofing Services|alanbrownroofing.co.uk
Albright Roofing Contractors|albrightroofing.net
Alden Roofing|www.aldenroofing.com
Aldworth Roofing Contracts|aldworthroofingcontracts.co.uk
Alf's Roofing|alfsroofing.com
Alincourt (Roofing)|alincourt.com
All Area Roofing & Construction|allarearoofingftp.com
All Seasons Roofing Services|unknown
All State Roofing|allstateroofing.com
All Surface Roofing and Waterproofing|www.asr-inc.us
Allen & Jane Roofing Contractors|allenandjane.co.uk
Allen Roofing & Siding|www.aroofing.net
Allied Commercial Roofing Services|www.alliedcommercialroofing.com
Allied Industrial Roofing Services|alliedindustrialroofing.co.uk
Allied Precision Roofing and Contractors|alliedprecisionrc.com
ALLIED ROOFING INSTALLATION SERVICES|alliedroofingwa.com
Allied Roofing Services (Wales)|unknown
Allied Roofing, Inc.|alliedroofinc.com
Alloy Roofing|www.alloyroofing.com
Allphase Restoration|www.allphaserestore.com
Allstate Roofing|allstateroofingaz.com
Alltype Roofing Contractors|atrc.co.uk
Ally Roofing Services|allyroofingservices.com
Alpha Roofing Services|alpharoof.co.uk
Alpine Roofing|www.alpineroofing757.com
Alpine Roofing (Commercial Services)|www.alpineroofing.net
Altec Roofing|www.altecroofing.com
Altitude Roofing Services|altituderoofingservicesltd.co.uk
Aman Roofing Services|unknown
Amastic Roofing, Building & Scaffolding Services|amastic.co.uk
Amber Roofing Services|amberroofingscotland.com
AMECO Solar & Roofing|amecosolar.com
America 1st Roofing & Builders|www.america1stroofing.com
America Building Materials (Los Angeles)|www.americabm.com
American Roofing & Metal Co.|amerroofing.com
Americano Roofing & Gutters|www.goamericano.com
Amf Roofing Contractors|amfroofingltd.co.uk
Amg Roofing Services|amgroofing.co.uk
ami roofing contractors inc.|amiroofingcontractors.com
Amstill Roofing|www.amstillroofing.com
Anchor Roofing Systems|www.anchor-roofs.com
Anderson Roofing Services|andersonroofingservices.org
Apex Roofing|apextx.com
Apex Roofing & General Contractors|apexroofing.biz
Apex Roofing & Restoration|www.apexroofs.com
Apex Roofing Services|apexroofingservicesltd.co.uk
Apple Roofing|www.appleroofing.com
Apple Roofing (Roofing Services)|www.appleroof.com
Applied Roofing Services|www.appliedroofingservices.com
Approved Rubber Roofing Contractors|arrcltd.co.uk
AR Roofing (Kansas)|www.arroofing.com
Ar Roofing Contractors|arroofingcontractorsltd.business.site
Arc Roofing & Building Contractor|isleofwightbuilding-arc.co.uk
Arcadia Roofing|www.arcadiaroofing.com
Arcadia Roofing and Siding|arcadiaroofinginc.com
Armstrong Roofing Services|unknown
Arocon Roofing & Construction|www.aroconllc.com
Arrow Roofing Services|www.arrowroofingservicesllc.com
Arrowhead Building Supply|www.arrowheadbuildingsupply.com
Arroyo's Roofing|arroyosroofingllc.com
ARS Construction|www.arsbuild.com
Artigues Roofing & Restoration Services|scroofclaim.com
Ashburn Pro Roofing|ashburnproroofing.com
Ashby's Building & Roofing Services|unknown
Aspect Roofing Services|aspectroofingservicesltd.co.uk
Aspire Roofing Contractors|aspireroofingcontractors.com
Aspire Roofing Services|aspireroofingservices.co.uk
ASSOC ROOFING CONTRACTORS OF NORTHERN CALIF|rcacal.com
ASSOCIATED ROOFING CONTRACTORS OF THE BAY AREA COUNTIES|arcbac.org
ASSOCIATED SHEET METAL AND ROOFING CONTRACTORS OF CONNECTICUT|associatedsheetmetal.org
ASSURE-U Roofing|assure-u.net
Aston Roofing Services|aston-roofing-services.business.site
ATD Roofing|www.atdroofing.com
Atlantic Roofing Distributors|www.atlanticroofingdistributors.com
Atlas-Apex Roofing|www.atlas-apex.com
Attyx|www.attyx.com
Authentic Roofing|authenticroofing.com
Av Roofing And Building|unknown
AVI Roofing|www.aviroofing.com
Avonside Group Services|www.avonsidegroup.co.uk
AWS Roofing Services|www.awsroofing.com
Ayrshire & Glasgow Roofing|ayrshireroofing.co.uk
AZ Roofing|azroofingct.com
B & M Roofing of Colorado|www.bmroofing.com
B and M Roofing Contractors|bmroofingcontractors.com
B C (Roofing Contractors)|bcroofing-newcastle.co.uk
B&L Sheet Metal & Roofing|www.blsheetmetalroofing.com
B&M Roofing Contractor|unknown
Bailey Roofing & Property Services|unknown
Bailey Roofing Contractors|baileyroofing.com
Baker Roofing|www.bakerroofing.com
Baley Roofing Contractors|roofingcontractorsseattle.com
Bar-B Roofing|barbroofing.com
Bartlett Roofing|www.bartlettroofs.com
Bath Roofing Contractors|bathroofingcontractorsltd.co.uk
Batterbee Roofing|batterbeeroofing.com
Bayside Siding & Roofing Contractor|baysidesidingnroofing.com
BDC Roof|www.bdclongislandroofing.com
Beachcomber Tours Limited|beachcombertours.uk
Beacon (Interior Products Business)|unknown
Beacon Roofing|www.beaconroofing.co.uk
Beacon Roofing Supply|www.becn.com
Belcher Contractors & Roofing|www.belcherroofinginc.com
Beldon Roofing & Remodeling|www.beldon.com
Best Choice Roofing & Home Improvement|www.bestchoiceroofing.com
Best Hands Roofing Contractors of Colorado Springs|besthandsroofingcoloradosprings.com
Best Roofing|www.bestroofing.net
BH Roofing (Other Commercial Services)|www.bhroofingsa.com
Big Rapids Roofing|bigrapidsroofing.net
Bigfoot Roofing & Construction|www.bigfootroofing.com
Bill Shields Roofing|billshieldsroofing.com
Birmingham Roofing Contractors|birmingham-roofing.net
Blackhawk Roofing Services|black-hawkroofing.co.uk
Blake Roofing Services|unknown
Blenheim Roofing Services|blenheimroofing.co.uk
Bliss Chimney Sweeps|chimneysweepsurrey.co.uk
Blue Angel Roofing & General Contractors|blueangelroofinggc.com
Blue Ribbon Roofing ( Other Commercial Services)|www.blueribbonroofingnc.com
Bluefern Building And Design Consultancy|tgriffiths-roofing.co.uk
BMI Group (Other Commercial Products)|www.bmigroup.com
Bms Roofing Services|unknown
Bob Jones Roofing Contractors|bobjonesroofing.co.uk
Bold North Roofing and Contracting|boldnorthroofing.com
Bolton Roofing Contractors|boltonroofing.co.uk
Bone Dry Roofing|bonedry.com
Boral Roofing, a Westlake Company|boralroof.com
Bowller Group|bowllersolar.co.uk
Bpr Roofing Services|bprroofing.co.uk
Bps Roofing Services|bpsroofing.com
Bracknell Roofing|www.bracknellroofing.com
Brads Roofing ()|sttammanyroofer.net
Brandon J Roofing|www.brandonjroofing.com
BRATTLEBORO ROOFING & SHEET METAL SERVICES|brsmservices.com
Bravo's Roofing|bravosroof.com
Brazen Roofing|brazenroofing.com
Brd Roofing Services|brdroofingservices.co.uk
Breakers Roofing And Building Contractors|breakersroofingandbuilding.co.uk
Bri-Den Roofing|www.bridenroofing.com
Bridgewater Roofing Contractors|bridgewaterroofing.net
Bridgewood Roofing & General Contractors|bridgewoodroofing.com
Briggs Roofing Services|rooferinleeds.co.uk
Broomfield Roofing Services|unknown
Brothers Services|www.brothersservices.com
Broward Roofing Supply of Hallandale|www.browardroofingsupply.com
Brown Roofing Contractors|brown-roofing.co.uk
Brown's Roofing|brownsroofingla.com
Brunwin Professional Roofing Services|brunwinroofing.co.uk
BSW Roofing Contractors|bswroofing.com
Bt Roofing Services|btroofingservices.co.uk
Bulldog Roofing|www.bulldog-roof.com
Bumble Roofing|www.bumbleroofing.com
Burgin Roofing Services|burginroofing.com
Burke Industries|www.burkeind.com
Burns & Scalo|www.burns-scalo.com
Bury Roofing Services|bury-roofing.co.uk
Byford Roofing Services|byfordroofing.com
Byrne Roofing Services|unknown
C Hynes Roofing Services|chynesroofing.co.uk
C J Roofing Services|roofingcountydurham.co.uk
C S Roofing Contractors|roofersineastbourne.com
C. J. S. Roofing Contractors|cjsroofing.co.uk
C.H.I. Roofing|731roof.com
C&J Harrison Roofing Services|candjharrisonroofingservices.co.uk
C|F Roofing|www.cfroofingllc.com
CA Group (Building Products)|www.cagroup.co.uk
Caden Roofing Services|cadenroofing.com
Cal's Roofing|calsroofing.com
Cambie Roofing Contractors|cambieroofing.com
Cambridge Wilson & Co.|www.cwcroofing.com
Camp Facility Services|www.campfs.com
Campany Roofing|campanyroofing.com
campbell roofing materials co|campbellroofingco.com
Cannon Roofing|www.cannonroofing.com
Canopy Home Exteriors|canopyhomeexteriors.com
CanPro Roofing Partners|www.canproroofing.com
Capital Roofing & Building Services|capitalroofs.co.uk
Capital Roofing Contractors|capitalroofingcontractors.com
Capital Roofing Services Edinburgh|capitalroofingservicesedinburgh.co.uk
Cardinal Roofing and Restoration|www.cardinal-roof.com
Carmen Roofing Services|www.carmenroofing.com
Carpenter's Roofing & Sheet Metal|www.carpentersroofing.com
CARRILLO ROOFING SERVICES|carrilloroofingswf.com
Carroll & Sons Roofing|www.carrollsons.com
Carter Roofing Services|carter-roofing.co.uk
Carvil Jones Roofing Contractors|southcheshireroofing.co.uk
Castile Roofing|www.castileroofing.com
Castle Damp-Proofing|castledampproofing.co.uk
Cater (Roofing Contractors)|caterroofing.co.uk
Cb Roofing Services|cbroofingsalisbury.co.uk
CCR Roofing Services|ccrroofingkc.com
CeDUR|www.cedur-roofing.squarespace.com
Centennial Roofing (Other Commercial Services)|www.centennialroofllc.com
CENTRAL | Roofing | Steel|centralroofinginc.com
Central Roofing|www.centralroofing.co.uk
Central Roofing Illinois|www.centralroofingllc.net
Centre Point Roofing Services|centrepointroofing.co.uk
CertainTeed|www.certainteed.com
Certified Roofing General Contractors|certifiedroofco.com
CFS Roofing Services|www.cfsroofing.com
Chamberlin Roofing & Waterproofing|www.chamberlinltd.com
Chattanooga Roofing Contractors|chattanoogacontractorsgroup.com
Childers Roofing & Sheetmetal|www.childersroofing.net
Choufani & Bailey Roofing & Restoration|www.choufaniandbailey.com
Chris Andersen Roofing and Erecting|www.chrisandersenroofing.com
Christianson Roofing|www.christiansonroofing.com
Cincinnati Roofing Contractor|cincinnati-roofing-contractor.com
Circle L Roofing & General Contractors|circlelroofingtx.com
Citadel Roofing & Solar|www.citadelrs.com
Citrus Roofing Contractors|citrusroofing.com
City Roofing And Asphalt Services|cityroofing.eu
CJ Roofing|www.cjroofing.com
Cj's Roofing|cjsroofingandbuilding.co.uk
Cladding & Roofing Contractors|claddingandroofing.com.au
Clark's Quality Roofing|www.clarkroof.com
Clarke Building And Roofing Services|clarkebuildingandroofingservices.co.uk
Classic Roofing and Construction|www.classicroofreplacement.com
Clay Roofing Services|clayroofingservices.co.uk
Clayton Roofing Contractor|claytonroofingcontractor.com
CLC Commercial Roofing|www.clccommercialroofing.com
Clover Roofing Services|cloverroofing.co.uk
Cls Roofing Specialists|clsroofingspecialists.co.uk
Clydevalley Roofing & Cladding Services|unknown
CMAC Roofing|cmacroofing.com
Cmh Leadwork And Roofing Services|cmhleadwork.co.uk
CMR Construction & Roofing|www.cmrconstruction.com
CNY Roofing|www.cnyroofingco.com
Coast To Coast Roofing & Building Contractors|c2croofs.com
Coastal Construction Roofing & Restoration|www.ccrrllc.com
Coastal Roofing Services|coastalrga.com
Cobalt Scaffolding|ems-scaffoldingandroofing.co.uk
Cole's Gutters & Roofing Services|colesguttersandroofingservices.uk
Collis Roofing|www.collisroofing.com
Columbia Roofing And Sheet Metal|reroofnow.com
Commercial Roofing|www.commercial-roofing.com
commercial roofing & waterproofing hawaii|commercialroofinginc.com
Commercial Roofing Contractor|www.yourcommercialroofer.com
Commercial Roofing Contractors / Crc Home Services|410roofthis.com
Commercial Roofing Services|aquagard-roofing.co.uk
Complete Roofing & Building Services|unknown
Complete Roofing Contractors|completeroofingcontractors.com
Complete Roofing Services|completeroofingservices.co.uk
Complete Roofing Services (Scotland)|crs-roofing-fife.com
Congoleum|www.congoleum.com
Conner Roofing|connerroofing.com
Contractor BG|www.contractorbg.com
Contractors Roofing & Supply Co.|contractorsroofing.com
Contractors Siding, Windows & Roofing Supply|www.contractorssupply.net
Coopers Roofing Contractors|coopersroofing.co.uk
Core Roofing Systems|www.coreroofing.net
Corey Construction|www.coreyconstruction.net
Cornerstone Construction|www.cornerstoneroofingandsolar.com
Cotton Holdings|www.cottonholdings.com
Cousins Building And Roofing Services|cousinsbuilders.co.uk
Coventry & Warwickshire Building & Roofing Services|apmroofingltd.co.uk
Cr Roofing Services|crroofingservicesltd.com
Cra Roofing Specialist|unknown
Craftsman Roofing Services|www.craftsmanroofingva.com
Cram Roofing|www.cramroofing.com
Crest Brick Slate and Tile|www.crest-bst.co.uk
Cresta Roofing Services|crestaroofingservices.co.uk
CRH Insulation Europe|unknown
CRM Roofing|www.crmroofing.com
Crown Industrial Roofing|www.crownroofing.ca
Crowther Roofing & Sheet Metal|www.crowtherroofing.com
Crowther Roofing And Cooling|www.crowther.net
Custom Roofing|unknown
Cw Roofing And Building Services|doncasterroofers.co.uk
D & G Roofing Contractors|www.dgroofingcontractorsal.com
D & S Roofing Single Ply Contractors|dsroofingtadley.co.uk
D J F Roofing Services|fands-roofing.co.uk
D J Roofing Contractors|djroofingcontractors.uksite.biz
D M B Flat Roofing & Building Services|dmbflatroofing.yolasite.com
D M Roofing Services|dmroofingservices.com
D P Mcnair Roofing Contractors|dpmcnair.co.uk
D Sewell Roofing Contractor|dsewellroofing.co.uk
D Townsend Roofing Services|dtownsendroofing.co.uk
D Walker Roofing Specialist|dwalkerroofing.co.uk
D. Kerrigan Slaters & Roofing Contractors|unknown
D.A. Bridger Asphalte Roofing Contractors|unknown
D.Garrison Roofing|www.dgarrisonroofing.com
D.J. Roofing Supply|djroofingsupply.com
D.J. Scriven Roofing Contractors|djscrivenroofing.co.uk
D.M. Roofing & Construction Services|dmroofing.ca
D.P. Roofing|dproofing.co.uk
D'Agostino Roofing|dagostinoroofing.com
Dalco Contractors & Roofing | BBB A+ | Hail Damage Repair|roofingdalco.com
Dale Roberts Construction|dalerobertsconstruction.co.uk
Dalkeith Roofing Services|dalkeithroofingservices.com
Dallas Commercial Roofs|www.dallascommercialroofs.com
Damage and Recovery Solutions|www.damagerecoverysolutions.com
Dan's Roofing|dansroofingincorporated.com
Darlington Roofing Contractors|darlingtonroofingcontractors.co.uk
Davco Roofing & Sheet Metal|www.davcoroofing.com
David Lundberg Building & Roofing Contractor|www.lundbergroofing.com
Davis Roofing And Building Services|davisroofing.co.uk
Davis Roofing Services|davisroofingservices.co.uk
Dayton Roofing & Renovation|www.daytoncontractingaustin.com
DBS ROOFING AND GENERAL CONTRACTORS|dbsroofingcontractors.com
DECRA Metal Roofing|www.decra.com
Deer Park Roofing|www.deerparkroofing.com
Delta Roofing Services|deltaroofing.co.uk
Deluxe Roofing Contractors & Suppliers|deluxeroofing.co.uk
Derek Lyall Home Improvements|unknown
Design Roofing & General Contractors|design-roofing.com
Designer Roofing | Roofing Contractor | Roof Repair|designerroofing.com
Devereux Roofing Services|devereuxroofing.com
Dh Roofing Services|dhroofingservices.co.uk
Diamond Everley Roofing Contractors|diamondeverley.com
Diamond Roofing & Guttering Services|unknown
DiGiorgi Roofing & Siding|www.digiorgiinc.com
Direct Roofing & Landscaping Contractors|unknown
Direct Roofing Services|directroofing.co.uk
Diversified Roofing|www.diversifiedroofing.com
Djs Roofing Services|djsroofingservices.com
Dodds Roofing Services|www.doddsroofing.co.uk
Dominion Siding|dominionx.com
Donaldson Door Systems|www.donaldsondoorsystems.co.uk
Done Right Roofing Services|donerightroofing.co.uk
Doug Oliver Development Residential & Commercial Roofing Contractors|dougoliverdevelopment.com
DR. Roofing|oklahomaroofingcontractor.net
Dri-Con Roofing|www.driconroofing.com
Drohan Builders|drohanbuildersltd.co.uk
Dry-Line Roofing|drylineroofingsolutions.co.uk
Dry-Tech Commercial Roofing Services|www.drytechroofing.com
Drytech Roofing|www.drytechroofingcompany.com
DSS Roofing | Contractor in Buffalo|dssroofing.com
Dsy Roofing & Building Contractors|dsycontractors.net
Ducks Roofing|www.ducksroofing.com
Dunne Roofing Services|dunneroofingservices.com
Dura Group (Roofing services)|www.duragroupin.com
Duro-last|www.duro-last.com
DVC Commercial Roofing Contractors|www.dvcroofing.net
DWS Roofing and Waterproofing Services|dwsroofing.com
Dynamic National|www.dynamicnational.com
DYNAMIC ROOFING CONCEPTS|dynamicroofingconcepts.com
E Spoors Roofing & Cladding Services|elliottspoors.co.uk
E-Z General & Roofing Contractors|ezgeneral.com
E. Ross & Sons (Roofing Contractors)|ersroofing.com
E.D. Roofing|edroofing.com
E&E Roofing Services|eeroofingservices.com
Eagle One Roofing Contractors|eagleoneroofing.com
Earl W Johnston Roofing|www.johnstonroofing.com
East Coast Roofing Contractors|eastcoastroofing.co.uk
East Sussex Roofing Contractors|unknown
Eberhard|www.eberhardco.com
EC Roofing & Home Services Direct|ecroofinginc.com
Ed's Loft Conversions|edsloftconversions.co.uk
Eden Queens Roofing Contractors|roofingcontractorsqueens.com
Eden Roofing & General Contractors|advanceroofingservice.com
Edilians|www.edilians.com
EEIC Realty (2,922 Square Foot Industrial Property in Stratford, Connecticut)|unknown
Eg Mt Roofing Services|unknown
Eidsvoll Tak og Håndverkstjenester|www.eidsvolltak.no
Eig Building And Roofing Contractors|eigltd.co.uk
Ejb Roofing Contractors|ejbroofingcontractors.co.uk
Eldridge (Construction and Engineering)|www.theeldridgeway.com
Elite Roofing & Cladding Services|derbyshire-roofer.co.uk
Elite Roofing & Remodel|www.eliteroofingnw.com
Elmer's Roofing|elmersroofing.com
Elo Roofing|www.eloroofing.com
Empire Roofing|www.empireroofing.com
Empire Roofing Claim Services|empirercs.com
Empire Roofing Contractors|empireroofing.co.uk
Empire Roofing Services|empireroofingservices.co.uk
Empire Roofing Services (Oxford)|empire-rs.co.uk
Energy Advantage Roofing and Solar|yourenergyadvantage.com
Enviro Tech Roofing Services|evtroof.com
Enviroshake|www.enviroshake.com
EnviroShield Roofing Services|enviroshieldroofing.com
Envision Roofing Services|unknown
Erie Home|www.eriehome.com
Eskola|www.eskola.com
Essence Roofing And Building Services|essencebuilding.co.uk
Essex Roofing & Building Services|essex-roofing-services.co.uk
Essex Roofing & Solar|unknown
Eustis Roofing|www.eustisroofing.com
Evans Roofing Company|www.evansroofingcompany.com
Everdry Roofing Services|everdryroofingservices.co.uk
Evergreen Roofing (Services Non-Financial)|www.evergreenroofingcharlotte.com
Excalibur Roofing Services|excaliburroofs.com
Excel Roofing Contractors|excel-roofing.com
EXCEL ROOFING SERVICES|excelroofingservices.co.uk
Expert Roofing Services|expertroofingeugene.com
Exterior Solutions by Craig's Roofing|exteriorsolutionscri.com
F M Roofing Services|unknown
F P Roofing Services|unknown
F-Wave|www.fwaveroofing.com
Fargo Roofing & Siding|www.fargoroofing.com
Farrell Roofing|farrellroofing.com
FCR Services LLC (DBA FairClaims Roofing & Construction)|fairclaimsroofingcompany.com
Feazel Roofing|www.feazelinc.com
Felt Roofing Contractors Bristol|frcroofing.co.uk
Ferris Roofing Contractors|ferrisroofing.com
Finley's Roofing|www.finleysroofing.com
Firefighter Roofing|www.firefighterroofing.com
First Rate Roofing Services|firstrateroofingservices.com
Fischer Roofing Contractors|fischerroofing.com
Five Star Roofing Consultants & Services|fivestarserviceswny.com
five star roofing contractors|five-star-roofing-contractors.business.site
Fk Facades|fkgroup.co.uk
Fleet Roofing And Scaffolding Services|unknown
Flynn Group of Companies|www.flynncompanies.com
Forbes Roofing Services|unknown
Forbister Roofing Inc. Roofing Siding Windows|forbisterroofinginc.com
Fort Wayne Roofing|unknown
FOX Roofing & General Contractors|foxroofing.co
Fox Roofing Services|unknown
Foxcroft Roofing Services|foxcroftroofingservicesltd.com
Francisco's Roofing|franciscosroofinginc.com
Front Range Roofing Systems|www.frontrangeroofing.com
Fry's Roofing|frysroofingkc.com
Ft Roofing Services|ftroofingservicesltd.co.uk
Full Service Roofing Contractor, Cs Roofing Company|csroofingcompany.com
Funderburk Roofing|funderburkroofing.com
G & L Roofing Investments|gandlroofing.co.uk
G And L Roofing Contractors And Son|unknown
G Lee Roofing Services|unknown
G.S. Moore Roofing Contractors|gsmooreroofing.co.uk
G.S.R. Roofing|www.gsrroofingsunnyvale.com
Galaxy Roofing Services|galaxyroofingservices.co.uk
Galloway Roofing|www.gallowayroofing.com
Gannon Wholesale|www.grs-inc.com
Garabar, Inc: Roofing Contractor|garabar.com
Garon-teed Roofing|manchesterroofingcontractor.com
Garrison Roofing Contractors|garrisonroofing.co.uk
Gb Roofing Contractors|gbroofingltd.com
Gb Roofing Services|gb-roofing-services.business.site
GC Restoration|www.gc-restoration.com
Gc Roofing Contractors|gcroofingcontractors.co.uk
Gd Roofing Services|gdroofing.com
Gdi Roofing Support Services|unknown
GeneralRoofing|unknown
Gk Roofing Services|swindon-roofing.com
Global Roofing Group|www.globalroofinggroup.com
Global Roofing Group (Acquired)|unknown
Gold Medal Roofing|www.goldmedalroofing.com
Good Contractors Roofing and Restoration|goodcontractorsroofing.com
Gorman Roofing Services|www.gormanroofing.com
Goto Roofing Services|unknown
Gradient Roofing Services|gradient-roofing-services-limited.business.site
GRAHAM BARKER ROOFING SERVICES|grahambarkerroofingservices.co.uk
Great Gen & Roofing Contractor|www.roofingcontractorbronx.com
Great Roofing & Restoration|www.greatroofing.com
Greenough & Sons Roofing Contractors|greenoughroofing.com
Greyhawk Roofing|www.greyhawkroofing.com
Grove Roofing|groveroofing.com
Grove Roofing Contractors|groveroofing.co.uk
Gt Roofing Services|gtroofing.co.uk
Guardian Roofing|www.guardianroofing.com
Guardian Roofing Systems|www.guardianroofingla.com
Gulf-Tex Roofing & Services|gulftexroofs.com
Gustafson Roofing|www.giroofers.com
Guy Brothers Roofing|guybrothersroofing.com
H & S Roofing Contractors|globalroofingcontractors.com
H. Recinos Roofing Contractors|recinosroofingnj.com
H.P. Roofing|hproofing.ie
H&H Local Roofing Services|hhlocalroofing.co.uk
H&K Roofing Contractors|h-k-roofing.co.uk
H&S Roofing Company|hsroofing.com
Hamilton Roofing|www.hamiltonroofinginc.com
Hammersmith Management|www.ehammersmith.com
Hammertime Contractors|www.hammertimecontractors.com
Hamptons Roofing Contractor|hamptonsroofingcontractor.com
Hancock Claims Consultants|www.hancockclaims.com
Handyman Roofing|handymanroofing.com
Harmony Roofing Services|harmonyroofing.co.uk
Harrison's Roofing|harrisonsroofing.com
Hartsfield Roofing & Construction|hartsfieldroofing.com
Harwood Roofing Contractors|harwoodroofing.co.uk
Haus Roofing And Construction Services|hausroofing.com
Hayden Roofing Contractors|haydenroofingcontractorsltd.com
Heidler Roofing Services|heidlerroofing.com
Helix Roofing Contractors|helixroofing.com
Helix Roofing Contractors Holdings|unknown
Heritage Roofing Midlands|heritageroofing-building.co.uk
Heritage Roofing Services|theheritageroofingservices.co.uk
Heritage Roofing.|heritageroofingco.com
Herman's Supply|hermanssupply.ca
Hernandez Services Roofing|www.roofhs.com
Hero Roofing|www.yourroofhero.com
Herts Beds & Bucks Roofing Services|bucksroofingservices.co.uk
Herts Roofing Contractors|hertsroofingltd.com
Hf Contractor|wwww.hfroofingcontractors.com
Hi-Tech Roofing & Sheet Metal|www.hi-techroofing.com
High Point Roofing & Remodeling|www.hproofs.com
Highland Commercial Roofing|www.highlandroof.com
Hjr Roofing Services|unknown
Holland Roofing|hollandroofing.com
Holtzlander Roofing and Services|holtzlanderroofing.com
Home Pro Roofing|homeproroofing.biz
Honest Abe Roofing|honestaberoofing.com
Hopkins Custom Roofing|hopkinscustomroofing.com
Horvath Roofing|horvathroofinginc.com
Howell Roofing Services|howellrs.com
Hrs (Roofing Services)|unknown
Hulsey Environmental Services|www.hulseyenvironmental.com
Hunt Roofing And Property Services|huntrps.com
I C Roofing Services|icroofingservices.co.uk
I H Roofing Services|ihroofing.co.uk
I-57 Roofing|i57roof.com
I. Higginson And Sons Roofing And Building Contractors|unknown
I. Reid & Sons (Roofing Contractors)|ianreidandsons.com
I.A.N. Roofing|unknown
IES Roofing Services|iesroofing.com
Imperial Roofing Contractor|imperialroofingcontractor.com
Impington Roofing Services Ltd Cambridge|impington-roofing.co.uk
Independent Roofing Contractor|independentroofingmt.com
Infinity Roofing and Siding|www.infinityroofer.com
Infinity Roofing Contractors|myinfinityroof.com
Inman Roofing Services|inman-roofing.com
Insulated Roofing Contractors|ircroof.com
Integral Roofing And Maintenance Services|integralroofing.co.uk
Integrity Roofing & Construction|www.integrityrc.com
Integrity Roofing & Gutters|www.integrityroofingfl.com
Integrity Roofing & Painting|www.integrityroofingandpainting.com
Interlock Metal Roofing|interlockroofing.com
Intermountain West Contractors - Roofing|iwcroofingutah.com
Interstate Roofing|www.interstateroofing.com
Interstate Roofing Company|www.interstateroofingco.com
IOWA ROOFING CONTRACTORS ASSOCIATION|iowaroofingcontractors.com
IPS (Compton)|www.ipscorp.com
Irish Roofing & Exteriors|www.irishroofs.com
Izzard Roofing Services|bedfordshire-focus.co.uk
J & L Welch Roofing & Paving Services|jlwelchroofing.co.uk
J & S Roofing And Bricklaying Contractors|jandsroofing.co.uk
J A Territt Roofing Services|jaterrittroofingaberdeen.co.uk
J Baguley Roofing Services|jbaguleyroofing.co.uk
J Bullman & Sons Building & Roofing Contractors|unknown
J P ROOFING SERVICES|jproofingservices.com
J Price Roofing Contractors|jpricecontractor.com
J. McFarland Roofing and General Contractor|jmcfarlandroofingandgeneralcontractorllc.net
J.A.L Roofing|jal-roofing.com
J.G. Roofing|jgroofingohio.com
J.O. Fox & Sons|unknown
J&K Roofing|jkroofing.com
J&m Contractors Of South Florida Inc. (Roofing Division)|roofpbc.com
J&M Roofing Services|jandmroof.com
Ja-Mar Roofing & Sheet Metal|www.jamarroofing.com
Jacksonville Roofing Contractor Emco Roofing|jacksonvilleroofing.net
Jacksonville Roofing Contractors|jacksonvilleroofingcontractorsnc.com
Jacobs Roofing Services|jacobsroofingservices.com
Jamie Roofing Contractor|jamieroofing.com
Janney Roofing|www.janneyroofing.com
Jay-Mar Roofing|jaymarroofingservices.co.uk
Jay's Roofing|jaysroofingwnc.com
Jbk Roofing Services|jbkroofingservices.co.uk
Jbl Roofing & Building Maintenance Contractors|jblroofingservices.co.uk
Jbs Roofing Services|jbsroofingservices.com
JC Built Roofing Contractor Poway|jcbuiltroofing.com
Jc Roofing & Building Services (UK)|jcroofingandbuilding.com
Jcs Roofing Services|unknown
Jdl Roofing Services|jdlroofingservices.com
JE Fournier Chimney & Roofing Contractors|jefournier.com
Jeff Harris Roofing Services|jeffharrisroofing.co.uk
JF Baker's Sons Roofing Contractors|jfbakerroofing.com
Jh Roofing Services|jhroofingservices.co.uk
JK PRO ROOFING|jkproroofing.com
JL Roofing Contractors|jlroofing.net
Jlp Roofing Contractors|unknown
Jlr Services Southern|jlrservicesltd.co.uk
Jme Roofing Services|jmeroofingservicesltd.co.uk
Jobba Trade Technologies|www.jobba.com
JOE'S ROOFING|joesroofing.net
John Cossey Roofing & Maintenance Contractors|unknown
John Flowers|johnflowers.co.uk
John Hogan Roofing|www.johnhoganroofing.com
John Minter Roofing Contractor & Construction|contractormedfordoregon.com
John Price Roofing Contractors|roofingtelford.co.uk
John Turner Roofing & Building Services|unknown
Jolly Roofing|www.jollyroofing.com
Jonathan Roberts Roofing Contractors|shropshireroofing.com
Jtl Roofing Services|jtlroofing.com
Jtmp Roofing Services|unknown
Julian Roofing Services|julianroofing.co.uk
jurin roofing services|jurinroofing.com
Jurin Roofing Services Inc. of Florida|jurinroofingflorida.com
Jw Roofing Contractors|jwroofing.co.uk
Jw Roofing Services, Warren Cross Roofing Inc. Dba|jwroofingservices.com
Jwm Roofing And Property Services|unknown
K & M Roofing And Building Services|kandmroofing.co.uk
K & S Roofing Contractors|unknown
K Humphries & Sons Roofing Contractors|khumphriesroofing.co.uk
K R Roofing & Building Services|krroofingandbuildingltd.co.uk
K Waddington And Sons Roofing Contractors|kwaddingtonroofing.com
K. A. Newman Roofing Services|kanewman.co.uk
K.A.S Roofing|unknown
K.N. Tagdækning|www.kntag.dk
K&M Services Roofing and Construction|kmservicepro.com
Kairos Roofing|www.kairosroofingllc.com
Kalkreuth Roofing & Sheet Metal|www.krsm.net
Karl Terry Roofing Contractors|kentpegs.com
Katy's Best Roofing & Siding Services|bestsidingandroofing.com
Kbl Roofing Contractor|kblroofingcontractor.com
Kellock Roofing Services|unknown
Kelly Roofing|www.kellyroofing.com
Kemp Roofing Contractors|unknown
Ken's Parkhill Roofing|www.parkhillroofing.com
Kennedy Roofing Services 1990|kennedyroofingservices1990.com
Keystone Commercial Roofing (Construction and Engineering)|www.keystonecommercialroofingnyc.com
Keystone Roofing Systems|keystoneroofingsystems.com
Kidd Roofing|www.kiddroof.com
Kilty Roofing Services|unknown
King Quality|www.kingquality.com
King Roofing Services|kingroofingservices.co.uk
King's Roofing|kingsroofing.net
Kingdom Roofing Systems|www.kingdomroofingsystems.com
Kirkin Exteriors|www.kirkinroofing.com
Kirtley & Sons Roofing|kirtleyroofing.com
Klaus Roofing Systems|klausroofingsystems.com
Knight Commercial|www.knightcommercial.com
Knight Roofing|knightroofing.com
Kodiak Roofing And Waterproofing|kodiakroofing.com
L J Teal Roofing Services|unknown
L Oliver And Son Roofing Contractors|loliverandson.co.uk
L S Roofing Services|lhcroofing.co.uk
L. Hough Building & Roofing Services|lhoughbrs.co.uk
L. K. Roofing Services|lkroofingservices.co.uk
L.I Roofing|liroofing.co.uk
L.I.D. Roofing|lidroofing.com
L.T.C. Roofing And Building Services|cotswoldprivateoffice.co.uk
Lafayette Roofing & General Contractors|lafayette-roofing.com
Lake Champlain Roofing|www.lakechamplainroofing.net
Lakeside Roofing Company (Commercial services)|www.lakesideroofingco.com
Landmark Roofing Services|landmarkroofingexperts.com
Latite Roofing and Sheet Metal|www.latite.com
Lavalion Roofing and Home Services|lavalionroofing.com
Lavey Roofing Services|www.laveyroofingservices.com
Lc Roofing Contractors|lc-roofing.com
Lee Moore & Sons Roofing Services|leemooreandsonsroofing.co.uk
Legacy Roofing|legacyroofing.com
Legacy Roofing (Commercial Services)|www.legacyoregon.com
Leicestershire Roofing Services|leicestershireroofingservices.com
Len's Roofing|lensroofing.com
Lenaghen Roofing Services|lenaghenroofing.com
Leo's Roofing|www.leosroofingsf.com
Letner Roofing|letner.com
Lewis Bros Roofing Contractors|lewisbrosroofing.co.uk
Lf Roofing Services|lfroofingservices.co.uk
Lifetime Quality|www.lifetimequalityroofing.com
Lifetime Roofing|www.lifetimeroofingla.com
Lindholm Roofing|www.lindholmroofing.com
Lindsay Roofing Contractors|unknown
Linear Roofing & General Contractors|www.linearroofing.com
Lloyd Roofing and Construction|lloydroofingservices.com
Lloyd Roofing Company|lloydroofing.com
Lloyd's Quality Roofing|lloydsqualityroofing.com
Local Roofing|www.local-roofing.com
Lockhart Roofing And Brickwork Services|lockhartroofingandbrickworkservices.co.uk
Long Home Products|longhome.com
Louisiana Roofing Contractors|www.lrcinfo.com
Lowden Roofing Contractors|unknown
Lr Roofing Services|lrroofing-kent.com
Lrf Roofing Services|roofingleicesterlrf.co.uk
Lubbock Roofing Contractor|lubbockroofingcontractor.com
Lynch Roofing Services (Ballaghaderreen)|unknown
Lyon Metal Roofing|wesellmetalroofing.com
M & C Roofing Contractors|mcroofing.co.uk
M & H Building & Roofing Services|mhbuildingandroofingltd.com
M B Roofing Services|mbroofingservices.com
M Cook & Son Roofing Contractors|mcookandsonroofingltd.co.uk
M J Daines Roofing Services|unknown
M J Mcauley Roofing Contractors|mcauleyroofing.co.uk
M J Sissons Roofing Services|mjsissonsroofingservices.com
M Marchant Specialist Lead Roofing Contractors|mmleadroofing.co.uk
M Thorp Roofing Contractors|mthorproofing.co.uk
M. Henrickson Flat Roofing Services|malcolmhenrickson.co.uk
M. Thompson Roofing Services|unknown
M.A.R. Roofing Services|marroofing.co.uk
M.A.T Roofing|matroofing.co.uk
M.A.V. Roofing|mav-roofing.com
M.C Roofing|mcroofingltd.co.uk
M3 Roofing Contractors Miami|roofingfrommiami.com
Ma Hooley (Roofing Contractors)|unknown
Mac Roofing Services|macroofingservices.com
Maccabees Roofing Contractors|maccabeesroofing.co.uk
Mahaney Group|www.mahaneygroup.com
Malarkey Roofing Co|www.malarkeyroofing.com
Mallard Roofing Group|unknown
Malone Roofing|www.ecmalone.com
Mammoth Roofing Services|usmammoth.com
Manhattan Roofing Contractors Nyc|manhattanroofingcontractorsnyc.com
Manning Dakbedekking|www.manning-dakbedekking.nl
Manny's Roofing|www.mannysroofing.com
Marathon Roofing & Services|marathonroof.com
Marc Richardson Building Services|unknown
Mardel Roofing Contractors|mardelroofing.co.uk
Marios|www.mariosroofing.com
Mark & Son Roof and General Contracting|www.markandsoninc.com
Mark Game Roofing Contractor|markgameroofingltd.co.uk
Mark Nelson 1st Class Roofing Services|1stclassroofingservices.co.uk
Marley Paul Smith Roofing Services|marleypaulsmithroofing.com
Marshels Roofing Contractors|marshels-roofing.co.uk
Martin Roofing Services|www.martinroofingservices.com
Martin Solar|www.martinsolar.net
Martin-Tomlinson Roofing|m-troofing.com
Massey Construction Group|www.masseyroofingservices.com
Master Roofing Services|masterroofingservices.com
Masters Roofing|masterswa.com
Masters Roofing (Other Commercial Services)|www.mastersroofinginc.com
Matt Sears & Sons Roofing Contractors|mattsearsroofing-torbay.co.uk
Max Abraham (Roofing Contractors)|maxabraham.co.uk
Max Sontz Roofing Services|www.sontzroofing.com
Mba Roofing Services|mbaroofing.co.uk
McCoy's|www.mccoys.com
Mcdonald Roofing Contractors|mcdonaldroofing.co.uk
Mcenany Roofing|mcenany.com
McHale Roofing|www.mchaleroofingfl.com
Mckinnis Roofing & Shtmtl|mckinnisroofing.com
MD Contracting Roofing & Masonry|www.mdcontractingnj.com
Meade Roofing Services|www.meaderoofingservices.com
Meades Roofing Services (Widnes)|unknown
MERIDIAN ROOFING SERVICES|meridianroofingservices.com
Merriman Roofing Contractors|merrimanroofing.co.uk
Met-Spec Roofing Services|metspec.co.uk
Metal Roofing - Piedmont Roofing|piedmontroofing.com
Metro Roofing & Metal Supply|www.metroroofingsupply.com
Metroll|www.metroll.com.au
Mg Construction (Hereford)|unknown
MICHAEL J. BONAIUTO, GENERAL ROOFING CONTRACTORS|michaelbonaiutoroofing.com
Mid America Roofing|maroofing.com
Mid City Roofing Services|midcityroofingla.com
Mid West Roofing Contractors Association|mrca.org
Midamerica Roofing|midamericaroofing.com
Midland Roofing Services (Holdings)|roofingderby.com
Midland Surfacing|unknown
MidSouth Construction, LLC - Commercial & Residential Roofing Contractor|roofingbymidsouth.com
Midwest Contractor|www.midwest-contractor.com
Mighty Dog Roofing|www.mightydogroofing.com
MILLER ROOFING SERVICES|millerroofingservices.com
Miller's Roofing Services|millersroofing.co.uk
Mills Siding & Roofing|www.millssidingandroofing.com
Mission Valley Roofing|missionvalleyroofing.com
Mj's Roofing And Building Services|unknown
Mjb Building Surveying And Roofing Services|unknown
Modern Roofing|modernroofing.com
Modern Roofing & Restoration|modernroofingtx.com
Monarch Roofing - Houston Roofing & Repair|monarch-roofing.com
Moray Roofing And Building Services|theitrefuge.co.uk
Morris Roofing Contractors|morrisroofing.co.uk
Mount Baker Roofing|mtbakerroofing.com
Mr. Roofing|mrroofing.net
Msb Roofing Services|msbroofing.co.uk
Mueller|www.muellerinc.com
Munz Roofing and Siding|www.munzroofing.com
N. & H. Roofing And General Contractors|unknown
N.V. Commercial Roofing|www.commercialroofingbronx.com
Nadco Roofing Services|nadcoroofing.co.uk
National Roofing|national-roofing.com
National Roofing Contractors Trade Show|unknown
National Roofing Partners|www.nationalroofingpartners.com
Nations Roof|www.nationsroof.com
Neligan Construction & Roofing|www.neliganconstruction.net
Nelson Roofing Contractors|nelsonroofing.net.nz
New Process Steel|www.nps.cc
New View Roofing Contractors|newviewroofingcontractors.co.uk
Newton Roofing Services|www.newtonroofingservicesdsm.com
NexGen Solar & Roofing|nexgenroof.com
Next Dimension Roofing|www.nextdimensionroofing.com
Next Generation Roofing Contractors|www.nextgrcroofing.com
Ng Roofing Services|roofingnottingham.com
Nick Brown (Roofing Contractor)|nickbrownroofing.co.uk
Nick Hayward Roofing Services|unknown
Nitro Roofing and Construction|nitroroofing.com
No Mess Roofing & Gutter Services|nomessguttersroofing.com
Noland's Roofing|www.nolandsroofing.com
Nor Cal Roofing|www.norcalroofing.com
Nordic Waterproofing Holding|www.nordicwaterproofing.com
Normandy Roofing Services|normandyroofingservices.co.uk
North American Roofing|www.naroofing.com
North Texas Roofing Contractors Association|ntrca.com
North West Roofing|www.northwest-roofing.com
North/East Roofing Contractors Association|nerca.org
Northpoint Roofing Systems|www.northpointroofingsystems.com
Northwest Roofing Supply (Roofing Division Assets)|www.roofingsupplygroup.com
Nra Roofing & Flooring Services|nraroofing.co.uk
NRC Roofing and Restoration|www.nrc4help.com
Nu-Tec Roofing Contractors|nutecroofing.com
O.J. Roofing|ojroofingandcarpentry.co.uk
O'Hara's Son Roofing|www.oharasson.com
O'Neal Jr. Roofing|onealjrroofing.com
Oak Roofing Services|oakroofing.co.uk
Oasis Roofing|www.oasisroofs.com
Oc Roofing Contractors|unknown
Oklahoma Roofing & Sheet Metal|www.oklahomaroofing.com
OMNIA Roofing|omniaroofing.com
On Demand Roofing And Property Services|ondemandroofingandpropertyservices.co.uk
On Top Roofing|www.ontoproofing.net
One Day Roofing|www.onedayroofing.com
Oshkosh Industrial Roofing & Sheetmetal|www.oshkoshindustrial.com
Ozark Roofing & Construction|ozarkroof.com
P M P Roofing Services|sitelift.website
P M Roofing Contractors|unknown
P S Dean Roofing Contractors|psdeanroofing.co.uk
P S Roofing Contractors|psroofing.net
P.B. Roofing Services|pbroofing.co.uk
P.Duckworth Roofing Services|middletonroofer.co.uk
P.R. Roofing|pandrroofinginc.com
P&R Roofing Contractors|pandrroofing.com
ParaTex Roofing & Construction|paratexms.com
Park Roofing Contractors|park-roofing.co.uk
Patrick's Roofing|patricksroofing.com
PAX Services Group|www.paxservicesgroup.com
PB Roofing|www.pbroofingco.com
Peacock Roofing-dallas Roofing Contractor|peacockroofing.com
Peak Roofing Contractors|peakroofingcontractors.com
Peak Roofing Partners|www.peakroofingpartners.com
Peak View Roofing|www.peakviewroofing.com
Pennsylvania Roofing Contractor|roofingcontractorspa.com
Perennial Roofing Contractors|perennialroofing.co.uk
Perimeter Roofing|www.perimeterroofing.com
Perry Roofing|www.perryroofing.com
Perry's Roofing|www.perryverroneroofing.com
PetersenDean|www.delphiforfun.org
Peterson Roofing (Roofing Services)|www.petersonroofingca.com
Phoenix Commercial Roofing|www.phoenixcommercialroofers.com
Phoenix Roofing & Building Contractors|phoenixrc.co.uk
Pieros Construction Co.|www.pierosroofing.com
Pink Energy|www.gopink.com
Pinkston Tadd, Inc. Commercial & Industrial Roofing Services|pinkston-tadd.com
Pinnacle Roofing Contractors|www.pinnacleroofing.com
Pioneer Roofing|www.pioneerroofing.net
Pioneer Roofing Systems|pioneerroofing.com
Pittman Waller Roofing Company|www.pittmanwaller.com
Pj Smith Roofing & Building Services|ashbrookfunerals.co.uk
Pj's Roofing|pjsroofing.com
Platinum Roofing|www.platinumroofllc.com
Platinum Roofing (Commercial Roofing)|www.platinumroofingmi.com
PMR Roofing|pmrroofing.com
Pnr Roofing And Building Services|unknown
PNW Roofing and Remodeling|pnwroofingandremodeling.com
Port Enterprises|www.portroofing.com
Portals Plus|www.portalsplus.com
Porter Roofing Contractors|porter-roofing.com
Pr Roofing Services|pr-roofing.co.uk
Precision Roofing|www.precision-roofing.co.uk
Precision Roofing Services|precisionroofinginc.net
Precision Roofing Services Of New England|roofinggloucester.com
Precision Roofing Systems|precisionroofingsystems.com
Preferred Roofing Services|www.preferredllc.net
Preferred Roofing Services (US)|www.preferredroofingservices.com
Premier Roofing (Commercial Services)|www.premierroofing.com
Premier Roofing & Building Services (Leeds)|premierroofingleeds.com
Premier Roofing & Siding Contractors|www.premierroofingandsiding.com
Premier Roofing Company|www.premier-roofing.com
Premier Roofing Contractors|premierroofing.co.uk
Premier Roofing Services (Bristol)|premierroofingbristol.co.uk
Premier Specialist Roofing Contractors|premier-src.co.uk
Prestige Roofing Contractors|prestigeroofingok.com
Priced-rite Roofing|pricedritenwi.com
Pride Roofing Services, Inc.|prideroofs.com
Prime Roofing (Commercial Roofing Services)|www.primeroofingmi.com
Priority Roofing|priorityroofs.com
PRITCHETT'S ROOFING|pritchettsroofing.com
Pro Roofing Contractors|www.proroofingcontractorsfl.com
pro roofing services|proroofingfl.com
Pro-Fit Roofing|pro-fitroofing.uk
Pro-Pave Surfacing|setinstonedriveways.co.uk
Pro-Shield Roofing & Construction|www.pro-shieldroofs.com
Pro-Tec Roofing|www.protecroofingsd.com
Pro-Trust Roofing|pro-trust-roofing.co.uk
Professional Roofing Services|www.denniscookroofing.com
Profix Roofing Services|profixroofingservices.co.uk
ProFormance Roofing|proformanceroofs.com
Progressive Roofing|www.progressiveroofing.us
Protech Roofing Services|www.hernandoroofer.com
ProWest|www.prowest.com
Pyramid Roofing|www.pyramidroofing.com
Qph Roofing Services|qphroofing.co.uk
Quality First Roofing (Florida)|www.qualityfirstroofingllc.com
Quality Miami Roofing Services|qualitymiamiroofing.com
Quality Roofing|qroof.com
Quality Roofing Contractor Of|qualityroofingcontractors.com
Quality Trusted Commercial Construction & Roofing|www.qtcommercial.com
Quick Roofing|www.quickroofing.com
Quinn Roofing Solutions|quinnsolutions.ca
R & I Construction Roofing Contractor|roofero.com
R & R Roofing Contractor|randrroofingri.com
R Bruce Roofing Contractor|unknown
R P B Building And Roofing Contractors|rpb-buildingandroofing.webeden.co.uk
R Payne Roofing Services|mdpayneroofing.co.uk
R S Purdey Roofing Contractors(Haslemere)|rspurdeyroofingweybridge.co.uk
R. Foy Roofing Services|unknown
R. T. Roofing Services|rtroofingservices.co.uk
R. W. Dawson (Roofing Contractors)|rwdawsonroofing.co.uk
R.Adams Roofing|radamsroofing.com
R.F. Watters Roofing And Building Contractors|rfwatters.co.uk
R.L.LOVATT LIMITED ROOFING CONTRACTORS|rllovatt.com
R&C Roofing Contractors Hawaii|roofinspectionhawaii.com
R1 Roofing Services|r1roofingservices.com.au
Ra Walker Roofing Services|rawalkerroofing.co.uk
Rackley Roofing|www.rackleyroofing.com
Radnor Group Holdings|www.radnorroofing.com
RAFTR Roofing + Exteriors|www.raftrxroofing.com
Rain Man Roofing & Waterproofing Services|rainmanroofing.com
Rainbow Roofing And Building Services|rainbowroofing.co.uk
Rational Roofing Services|rationalroofingservices.com
Rayco Roofing Contractors|raycoroofing.com
Rcat - Roofing Contractors Association Of Texas|roofingcontractors-texas.com
Rch Roofing Services|unknown
RCI Roofing Supply Company|www.rciroofingsupply.com
Rcl Contractors|rclcontractors.co.uk
Rcrt Roofing Contractors Designated Activity Company|unknown
React Roofing Services|reactroofingservices.co.uk
Ready Roofing & Solar|goreadysolar.com
Reclamation Roofing (formerly Jack's Roofing)|reclamationroofing.com
Redclad Roofing Services|redcladroofing.co.uk
Register Roofing|www.registerroofing.com
Reliant Roofing|www.reliantroofing.com
Remedy Roofing|www.remedyroofing.com
RENAISSANCE HISTORIC EXTERIORS|www.historicexteriors.com
RENCO Roofing|rencoroofing.com
Renown Roofing and Construction|www.renownconstruction.com
ResCom Roofing|rescomva.com
Results Roofing|www.resultsroofing.com
Revolution Contractors|www.revolutioncontractors.com
Rich's Roofing|richsroofing.com
Richmond VA Roofing|richmondvaroofing.com
Ricks Main Roofing|ricksmainroofing.com
RidgeLine Roofing & Restoration|goridgelineroofing.com
Ridgeline Roofing & Restoration (Odenville)|www.ridgeline-roofing.com
Right Way Roofing|www.therightwayroofing.com
Right-Hand Roofing|right-handroofing.com
Right-on Roofing|rightonroofinginc.com
Rike Roofing Services|rikeroofing.com
Rise Up Roofing|unknown
Rising Star Roofing|www.risingstarroofing.com
Rm&S Roofing Services|rmandsroofingservices.co.uk
RML Roofing Contractor|www.rmlfs.co.uk
Roadrunner Roofing Supply|www.roadrunnerroofingsupply.com
Robin's Roofing|robinsroofingservices.com
Robinson (Machinery)|www.robinsoninc.com
Robinsons Roofing Contractors|unknown
Robinwill Roofing & Building Services|robinwill.co.uk
Rock Roofing Contractors|unknown
ROCKY MOUNTAIN ROOFING SERVICES|rockymountainrfg.com
Roman Roofing|www.romanroofing.com
Roman's Roofing|romansroofingnc.com
Ron Crow & Son Roofing Contractors|roncrowroofing.com
Roof Consulting Services|www.roofdesign.com
Roof Services (New York)|www.roofservices.com
Roofco (Other Commercial Services)|www.roofco-inc.com
Roofer.com|www.roofer.com
Roofing|cdtbuildingandroofing.co.uk
Roofing - Flagstone Roofing & Exteriors|flagstoneroofing.com
Roofing & Reconstruction Contractors Of America|www.rrcausa.com
Roofing & Repair Services|roofingandrepairservices.com
Roofing And Supplies|www.roofingandsupplies.com
Roofing by Curry|roofingbycurry.com
Roofing Cladding & Felting Services|rcfroofingservices.com
Roofing Contracto-the Cool Roofing|thecoolroofingcompany.com
Roofing Contractor|roofingcontractor.com
Roofing Contractor Ads|roofingcontractorads.com
Roofing Contractor Fort Wayne|roofingcontractorfortwayne.com
Roofing Contractor Marketing|roofingcontractormarketing.com
ROOFING CONTRACTORS ASSOCIATION OF HAWAII|rcah.org
Roofing Contractors Association of Washington|rcaw.com
Roofing Contractors Knoxville Tn|roofingcontractorsknoxvilletn.net
roofing contractors network|roofingcontractorsnetwork.net
Roofing Contractors of Texas|roofingcontractorsugarland.com
Roofing Corp of America (Atlanta)|www.roofingcorp.com
Roofing King|www.roofingking.com
Roofing Master Contractor|roofingmastercontractor.com
Roofing Products & Building Supply|www.rfgproducts.com
Roofing Repair Contractors Paterson Nj|jcbrothersconstruction.com
Roofing Services|unknown
Roofing Services (Hartford)|unknown
Roofing Services Midland|roofingservicesmidlandltd.co.uk
Roofing Services Now|roofingservicesnow.com
Roofing Services of New England|www.roofingservicesofnewengland.com
ROOFING SIDING GUTTER CONTRACTORS|rsgcroofing.net
Roofing Solutions|www.roofingsolutionsllc.com
Roofing Solutions & Services|unknown
Roofing Solutions.|www.roofingsolutionstn.com
Roofing Supply Group|www.rsgroof.com
Roofing Technical Services|roofingtechnical.com
ROOFING TRADE SERVICES|roofingtradeservices.co.uk
Roofix Roofing|roofixtx.com
Roofline Developments|rooflinedevelopments.co.uk
Roofs By Nicholas|www.roofsbynicholas.com
Rooftek Roofing Supplies|unknown
Roofwise Roofing Services|coastbusiness.co.uk
ROQUE'S ROOFING|roquesroofing.com
Roscoe Roofing Services|roscoeroofingservices.business.site
Roseberry Roofing|roseberryroofing.co.uk
Ross Roofing Contractors|rossroofingcontractors.co.uk
Rossetta's Roofing|rossettasroofing.com
Roundway Roofing Contractors|roundwayroofing.co.uk
Royal American Services|www.rasroofs.com
Royalty Roofing|www.royaltyroofing.com
Rs Roofing Services|rs-roofing.co.uk
RSI Building Products|www.rsibp.com
Rtc Roofing Contractors|rtcroofingcontractors.co.uk
RTI Roofing Services|www.rtiservicesinc.com
RVA ROOFING SERVICES|rvaroofingservices.com
S & J Roofing Services|cjroofing.co.uk
S G Elliott Roofing Contractors|unknown
S R Roofing Services (Abersoch)|srroofingservices.co.uk
S T L Roofing Services|unknown
S V Roofing Services|svroofingservicesltd.co.uk
S.E.M. Roofing|unknown
S.J. Wilson (Roofing Contractors)|unknown
Saffron Walden Roofing Contractors|saffronwaldenroofingservices.co.uk
Samurai Roofing Services|samurairoofingservices.com
San Francisco Roofing Services|www.sfroofingservices.com
Sandbach Roofing Contractors|sandbachroofing.com
Sb Roofing|sbroofing.com
Sbp Roofing Services|unknown
Scaffolding And Roofing Services|thtscaffolding.co.uk
Schoen's Roofing|schoensroofing.com
Schultz Roofing Supply|www.schultzroofingsupply.com
SCI Roofing Services|www.sciroofingservices.com
Scott Roofing Contractor|scottroofingcontractor.com
Scott Thornton Roofing Contractors|scottthorntonroofingcontractors.co.uk
Scott's roofing|tscottroofing.com
Scott's Roofing (Roofing service)|www.scottsroofingcolorado.com
Scozzari Roofing Services|www.roofservicesconsulting.com
Scs Roofing Services|scsroofing.co.uk
Select Roofing Services|selectroofsatl.com
Sequoia Insulation|www.sequoia-ins.com
Sergio Lopez Roofing Services|sergiolopezroofingservices.com
Seven Hills Roofing Contractors|www.sevenhillsroofing.com
Sha Contractor Roofing And Guttering|unknown
Shakespeare Roofing And Building Contractors|shakespeareroofing.co.uk
Shamrock Roofing Services|shamrockroofingservices.com
Shellis Roofing Services|shellisroofing.co.uk
Sheridan Roofing & Building Services|sheridanroofingandbuilding.com
Sherwood Roofing Contractors|sherwoodroofing.co.uk
shingle hut complete roofing services|shinglehutroofing.com
SHINGLE MASTERS ROOFING & CONSTRUCTION SERVICES|shingle-masters.com
Showtime Roofing|showtimeroofing.com
Sidcup Roofing Services|sidcuproofing.co.uk
SIG|www.sigplc.com
Signal & Hobbs - Roofing & Cladding Contractors|sighob.com.au
Signature Roofing|signature-roofing.com
Simon Roofing|simonroofing.com
Simpson Dennis Roofing Services|simpsondennis-roofing.co.uk
Single Ply Structures|spsflatroofing.co.uk
Sj Roofing Services|sj-roofing.co.uk
Sjb Roofing Services|sjbroofing.com.au
Skyline Roofing & Sheet Metal Company|www.skylineroofing.net
Skyline Roofing Partners|www.skylineroofingpartners.com
Skymark Roofing|www.skymarkroofing.com
Skyview Roofing (Commercial Services)|www.skyviewroofingmcallen.com
Slate Roofing Contractor|slateroofing.com
SLATE ROOFING CONTRACTORS ASSOCIATION OF NORTH AMERICA|slateroofers.org
SMC Roofing Solutions|unknown
Snyder Roofing & Shtmtl|snyder-builds.com
Solar Educational Events (American Contractor / ContractorCoachPRO / Solar Integrated Roofing)|unknown
Solid Roofing Services|solidroofingservices.co.uk
Solis Roofing Contractors|solisroofingcontractorsinc.com
Solvikin Kattohuolto|www.solvikinkattohuolto.fi
Sorensen Roofing and Exteriors|www.sorensengc.com
Soto Roofing Services|sotoroofingservices.com
South East Roofing Services|southeastroofing.co.uk
Southeastern Roofing|www.southeasternroofing.com
SOUTHERN COUNTIES ROOFING CONTRACTORS|southerncountiesroofing.com
Southern Premier Roofing|southernpremierroofing.com
Southern Roofing & Exteriors|www.southernroofingandexteriors.com
Southern Roofing and Renovations|www.southernrnr.com
Southern Roofing Company|www.srctn.com
SPAN ROOFING CONTRACTORS|spanroofing.com
Spann Roofing & Sheet Metal|spannroofing.com
Specialty Roofing|www.specialty-exteriors.com
Spencer Roofing Services|spencerroofingservices.co.uk
SPG roofing & exteriors|www.spgroof.com
Sph Roofing Contractors|sphroofing.co.uk
Springfield (Commercial Roofing & Transport Services)|springfieldroof.com
Sps Roofing Contractors|unknown
SRS Distribution|www.srsdistribution.com
Ss Roofing Services|ssroofingltd.co.uk
Standard Roofing Company|standardroofingva.com
Starmark|www.starmarkroofing.com
Statewide Roofing|www.swroof.com
Stellar Roofing and Home|stellarroofing.com
Stephen Richardson Roofing Services|unknown
Sterling Commercial Roofing|www.sterlingroofing.com
Sterry Roofing Services|sterryroofing.co.uk
Stonebridge Roofing|stonebridge-roofing.com
Stonegrove Roofing Partners|www.stonegroveroofing.com
Storm Guard|www.stormguardrc.com
Storm Plumbing & Roofing Services|unknown
Stout Roofing|stoutroofing.com
Stratus Construction & Roofing|www.stratusroofing.com
Streamline Roofing Company|streamlineroofingco.com
Streamline Roofing Services|fairfieldroofingcompany.com
Strength Roofing & Siding|www.strengthroofingandsiding.com
Strictly Roofing|strictlyroofing.com
Stripes Roofing|www.stripesroofing.com
Style Roofing, Inc|styleroofing.com
Sullivan & Fortner Roofing|sullivanfortner-roofs.com
Sully-Jones Roofing|sully-jones.com
Summit Commercial Roofing|www.summitcommercialroofing.com
Summit Roofing ( Real Estate Services)|www.summitroofingks.com
Summit Roofing & Cladding Services|claddingservices.com
Summit Roofing Services|summitroofingservices.com
Sun Coast Roofing Services|brevardcountyroofer.com
Sunnyside Roofing Services|sunnysideroofingservices.com
SUNRISE ROOFING SERVICES|sunriseroofingservices.com
Super Dry Roofing & Building Services|superdryroofing.com
Superior Roofing|www.superiorroofing.com
Supreme Roofing & Construction|www.officialsupreme.com
Supreme Roofing Services|supreme-roofing.com
Sure Thing Roofing Contractor|surethingroofingcontractor.com
Sure-Tite Roofing|suretiteroofs.com
Sutter Roofing|www.sutterroofing.com
SV Roofing.|www.sv-roofing.com
Swift Roofing Services|swiftroofingservices.co.uk
T & S Roofing|tsroofingandbuilding.co.uk
T Drake Roofing Services|tdrakeroofing.co.uk
T Peel Roofing Contractors|tpeelroofing.co.uk
T&J Ottewill Roofing Contractors|unknown
TAFT ROOFING|taft-roofing.com
Tall Ridge Roofing Services|tallridgeroofing.co.uk
TALLEY'S ROOFING CO.|talleysroofing.com
Tamko Building Products|www.tamko.com
Tandragee Roofing Company & Building Services|roofingcontractorcraigavon.co.uk
Tarrant Roofing|tarrantroofing.com
Taylor Plastering, Building And Roofing Services|unknown
Taylor Roofing Contractors|www.taylorroofingltd.co.uk
Taylors Roofing Contractors|taylorsroofing.co.uk
Team-D Property Services|unknown
Technodak|www.technodak.nl
Tecta America|www.tectaamerica.com
Tectum Roofing|www.weroof.com
Tek-line Roofing|teklineroofing.com
Templar Roofing Services|templarroofing.co.uk
Tenholder Roofing And Construction Services|tenholderroofing.com
Tg Roofing Services|tg-roofing-services.business.site
Tgc Roofing And Building Services|unknown
The Castle Services|www.thecastleservices.com
The National Federation Of Roofing Contractors|nfrc.co.uk
The Roofing & Remodeling Company|theroofingcompany.com
Thomas Jefferson Roofing & Remodeling|www.thomasjeffersonroofing.com
Thompsons Slate & Tile Roofing Contractors|thompsonroofingtorquay.co.uk
Tidewater Roofing|tidewaterroofing.com
Tilehurst Roofing Contractors|berkshireandreadingroofing.co.uk
Titan Roofing (Commercial Services)|www.commercialroofingtitans.com
Tjs Roofing And Property Services|unknown
TMJ Construction Services|www.tmjconstructionservices.com
Tony G. Harris & Sons Building Contractor|tghandsons.com
Tony Mccorisken Roofing And Building Services|tonymccoriskenroofing.co.uk
Top Line Roofing Contractors|toplineroofingcontractors.com
Top Tower Roofing Service|www.toptowerroofingservice.com
Torres-boren Roofing|torresborenroofing.com
Total Home Roofing|www.throofing.com
Total Roofing & Construction Services|trc-inc.com
Total Roofing Contractors|totalroofing.net
Total Systems Roofing|www.totalsystemsroofing.com
Tough As Nails Roofing Contractors|toughasnailscontractors.com
Town & Country Roofing Services|unknown
Townsend Roofing and Construction Services|townsendroofing.com
Tradesmen Building Roofing Services|tradesmenbuildingroofing.co.uk
Transformation Roofing & Home Services|transformationroofing.com
Tri State Aluminum Products of Wisconsin|unknown
Tri State Roofing Contractors|www.tstateroofing.com
Tri-C Roofing Supply|unknown
Tri-Cities Roofing|tri-cities-roofing.com
Tri-Town Roofing|tritownroofing.com
Triad|www.triadfirst.com
Triad Roofing Services|triadroofingservices.com
Triangle Roofing Services|triangleroof.com
Tridom Roofing|www.tridomroofing.com
Trinity Restoration and Roofing|trinityrestorationfl.com
Triskell|triskellproducts.co.uk
Triumph Roofing - Charlotte Top Roofing Company|triumphroofingcharlotte.com
Tropical Roofing Services|www.tropicalroofingflorida.com
TRP Roofing Products|www.tropicalroofingproducts.com
True Metal Solutions|www.truemetalsolutions.com
TrussPoint Roofing & Exterior Renovations|trusspt.com
Ts Roofing Services|unknown
Tudor Roofing|tudorroofingspecialists.com
Turner Roofing & Sheet Metal|www.turnerroofing.com
Turpin Roofing Contractors|turpinroofing.co.uk
Tuscano-Maher Roofing|www.tmrroofing.com
TZ ROOFING CONTRACTORS|tz-roofing.com
U.S. Roofing|us-roofing.com
Unified Service Partners|www.unifiedservicepartners.com
United Contractors Roofing|myrtle-beach-roofing.com
United Roofing|www.unitedroofingdc.com
United Roofing & Construction Services|www.unitedroofingservices.com
United Roofing Supply|www.unitedroofingsupplytx.com
Urena Roofing & Contractor|urenaroofing.com
US Prime Roofing|usprimeroofing.com
US Roofing|www.usroofing505.com
Valentine Roofing|valentineroof.com
Vanity Roofing - Ottawa Roofing Company|vanityroofing.ca
VBR Roofing|vbrroofing.com
Venture Roofing & Building Supply|vrbsupply.com
VERMONT ROOFING CO|vermontroofing.com
Vertex Roofing (Commercial Services)|www.vertexroofing.com
Vertex Roofing Contractors|vertexroofinc.com
Vertical Roofing|verticalroofing.com
Vezer's Roofing|www.rooferfairfield.com
Vigilante & Family Roofing Services|vigilanteroofing.com
Virginia Pro Roofing|virginiaproroofing.com
Virginia Roofing Corporation|varoofing.com
Vision Building And Roofing Services|visionbuilding-services.co.uk
Vision-On Roofing Services|visiononroofing.co.uk
Vjr Roofing Services|roofing-in-leeds.co.uk
Volsen Ltd - Commercial Roofing Services|volsen.co.uk
W Carpenter & Son Roofing Contractor|wcarpenterandsonroofingcontractor.co.uk
W H Building And Roofing Services|unknown
W.E. Brown Roofing|www.webrownroofing.com
Wager Contracts|flatrooferromford.co.uk
Wagner Roofing & Construction Solutions|www.trustwagner.com
Warren Roofing & Insulating|www.warrenroofing.com
Washington Roofing Services|waroofingservices.com
Wayman Roofing Services|waymanroofing.co.nz
Wayne's Roofing|www.waynesroofing.com
Weald Roofing Services|wealdroofingservicesltd.co.uk
Weather Shield Roofing Systems|weathershieldusa.com
WeatherGuard Roofing (Real Estate Services)|unknown
Weathermaster Roofing Services|weathermasterroofingservices.com
WeatherShield Roofing & Sheetmetal|www.weathershieldroofs.com
Weathershield Roofing And Building Contractors|weathershield-ltd.co.uk
Weathertight Roofing (Commercial Services)|www.weathertight.co.uk
Weathertite Roofing Services|unknown
Weddle & Sons|www.weddleandsons.com
Welwood Special Projects|welwood.co.uk
West County Roofing & Construction|www.westcountyroof.com
West Orange Roofing|www.westorangeroofing.com
West Roofing (Other Commercial Services)|www.westroofing.com
Westchase Roofing Services|westchaseroofing.com
Western States Roofing Contractors Association|wsrca.com
Western Summit Roofing Contractors|westernsummitroofing.com
Western Timber and Building Supplies|www.wtbsbuildingsuppliesltd.co.uk
Westfall Roofing|www.westfallroofing.com
Westlake DaVinci Roofscapes|www.davinciroofscapes.com
WHEELER ROOFING SERVICES|wheelerroofingservices.net
Whitaker Roofing|www.whitakerroofing.com
Whitco Roofing Inc.|whitcoroofing.com
White Roofing Services|whiteroofingservices.com
Wicks Roofing|www.wicksroofing.com
Willi Roofing Services|williroofing.com
Wilsey Roofing|wilseyroofing.com
Wm. Green Roofing|wmgreenroofing.ca
Wooster Roofing & Construction Company|www.woosterroof.com
Wormley Brothers Enterprises|www.wormleybrothers.com
Worthmann Roofing|www.worthmannroofing.com
Wrights Roofing Services|wrightsroofingservices.com
Wrps Group|wrpsltd.co.uk
Yellowhammer Roofing|yellowhammerroofing.com